1646 1526 1687 1485 1607 1445 1526 1526 1685 1488 1448 1568 1485 1765 1568 1607
1526 1605 1485 1687 1525 1647 1446 1566 1765 1567 1527 1485 1687 1526 1488 1686
1447 1448 1605 1687 1446 1485 1567 1686 1646 1446 1685 1725 1568 1567 1725 1485
1525 1486 1725 1765 1445 1766 1645 1766 1487 1446 1607 1565 1607 1566 1528 1488
1526 1567 1687 1687 1605 1567 1446 1645 1607 1685 1526 1485 1606 1645 1525 1567
1606 1445 1727 1606 1448 1727 1528 1487 1526 1727 1607 1647 1766 1448 1605 1605
1486 1567 1647 1686 1766 1686 1447 1685 1766 1645 1567 1726 1445 1607 1446 1527
1487 1528 1565 1488 1568 1687 1568 1486 1567 1645 1568 1646 1727 1647 1528 1527
1687 1645 1487 1765 1606 1686 1527 1566 1765 1486 1605 1445 1646 1646 1567 1447
1525 1526 1448 1526 1727 1527 1687 1566 1447 1525 1567 1487 1488 1646 1767 1687
1686 1607 1485 1448 1725 1766 1487 1607 1528 1645 1606 1685 1687 1528 1646 1767
1445 1447 1646 41 41 41 1645 1646 1447 1568 1725 1525 1487 1525 1525 1567
layer1
2399 2399 6 7 8 9 10 2399 2399 2399 2399 2399 2399 2399 2399 2399
2399 2399 46 47 48 49 50 2399 2399 2399 1805 1806 2399 2399 2399 2399
2399 2399 86 87 88 89 90 2399 2399 2399 1845 1846 2399 2399 2399 2399
2399 2399 126 127 128 129 130 2399 2399 2399 1885 1886 2399 2399 2399 2399
2399 2399 166 167 168 169 170 2399 2399 2399 2399 2399 2399 2399 2399 2399
2399 2399 2399 2399 2399 2399 2399 2399 2399 2399 2399 2399 2399 2399 2399 2399
2399 2399 2399 2399 2399 2399 2399 2399 2399 2399 2399 2399 2399 2399 2399 2399
2399 1805 1806 2399 2399 2399 2399 2399 2399 2399 2399 1805 1806 2399 2399 2399
2399 1845 1846 2399 2399 2399 2399 2399 2399 2399 2399 1845 1846 2399 2399 2399
2399 1885 1886 2399 2399 2399 2399 2399 2399 2399 2399 1885 1886 2399 2399 2399
2399 2399 2399 2399 2399 2399 2399 2399 2399 2399 2399 2399 2399 2399 2399 2399
2399 2399 2399 2399 2399 2399 2399 2399 2399 2399 2399 2399 2399 2399 2399 2399
layer2
0 0 0 0 0 0 0 0 0 0 0 0 0 0 0 0
1 1 1 1 1 1 1 1 1 1 1 1 1 1 1 1
0 0 3 0 0 0 5 0 0 0 0 0 0 0 0 0
0 0 3 0 0 0 5 0 0 0 0 0 0 0 0 0
0 0 7 4 12 4 8 0 0 0 0 0 0 0 0 0
0 0 0 0 0 0 0 0 0 0 0 0 0 0 0 0
0 0 0 0 0 0 0 0 0 0 0 0 0 0 0 0
0 0 0 0 0 0 0 0 0 0 0 0 0 0 0 0
0 0 0 0 0 0 0 0 0 0 0 0 0 0 0 0
0 0 0 0 0 0 0 0 0 0 0 0 0 0 0 0
0 0 0 0 0 0 0 0 0 0 0 0 0 0 0 0
0 0 0 0 0 0 0 0 0 0 0 0 0 0 0 0